%%%%%%%%%%%%%%%%%%%%%%%%%%%%%%%
%%%%%%%%%%..............%%%%%%%
%%%%%%%%%%%.%%%%%%%.%%%.%%%%%%%
%%%%%%%%%......%......%.%%%%%%%
%%%%%%%%%.%%%%.%.%%%%...%%%%%%%
%%%%%%%%%.%......%%%%.%...%%%%%
%%%%%%%%%.%.%%% %%%%%.%%%.%%%%%
%%%%%.......%     %.......%%%%%
%%%%%.%%%%%.%%%%%%%.%.%%%%%%%%%
%%%%%...%%%....%....%.%%%%%%%%%
%%%%%%%.%%%%%%.%.%%%%.%%%%%%%%%
%%%%%%%.%%%....%......%%%%%%%%%
%%%%%%%.%%%.%%%%%%%.%%%%%%%%%%%
%%%%%%%........P....%%%%%%%%%%%
%%%%%%%%%%%%%%%%%%%%%%%%%%%%%%%
