%%%%%%%
%.....%
%.....%
%.....%
%%%...%
%%%.%%%
%%%..P%
%%%%%%%