%%%%%%%
%%%...%
%%%.%%%
%%%...%
%P..%.%
%.%%%.%
%.....%
%%%%%%%