%%%%%%%%
%......%
%.P%%%%%
%%%%%%%%