%%%%%%%
%.....%
%.....%
%.....%
%%%...%
%%%.%%%
%%%...%
%%%%%.%
%%%...%
%%%.%%%
%%%...%
%P..%.%
%.%%%.%
%.....%
%%%%%%%